W0W0W0W0W0W0W0W0W0W0W0W0W0W0W0W0W0W0W0W0W0W0W0W0W0W0W0W0W0W0W0W0W0W0W0W0W0W0W0W0W0W0W0W0W0W0W0W0W0W0
W0W0W0W0W0W0W0W0W0W0W0K0F0F0F0P0G0W0W0W0W0W0W0W0W0W0W0W0W0W0W0W0F0F0F0F0F0F0F0F0F0F0F0F0F0F0F0F0F0W0
W0W0W0W0W0W0W0W0W0W0W0W0W0F0W0W0W0W0W0W0W0W0W0W0W0W0W0W0W0W0W0W0F0F0F0F0F0F0F0F0F0F0F0F0F0F0F0F0F0W0
W0F0F0C0P0G0A0F0A0F0P0F0F0F0W0W0W0F0F0W0W0W0W0W0W0W0W0W0W0W0W0W0F0F0F0F0F0F0F0F0F0F0F0F0F0F0F0F0F0W0
W0F0F0F0P0L0F0L0F0L0P0F0F0F0W0W0F0F0F0F0F0W0W0W0W0W0W0W0W0W0W0W0F0F0F0F0F0F0F0F0F0F0F0F0F0F0F0F0F0W0
W0F0W0F0W0F0W0F0W0F0W0F0W0F0W0F0F0W0P0W0F0K2W0W0W0W0W0W0W0W0W0W0F0F0F0F0F0F0F0F0F0F0F0F0F0F0F0F0F0W0
W0F0W0F0W0P0W0P0W0P0W0F0W0F0W0W0F0F0F0W0P0W0W0W0W0W0W0W0W0W0W0W0F0F0F0F0F0F0F0F0F0F0F0F0F0F0F0F0F0W0
W0F0F0F0F0F0F0F0F0F0F0F0F0F0W0W0W0W0F0F0F0W0W0W0W0W0W0W0W0W0W0W0W0W0W0W0W0F0F0F0F0F0F0F0F0F0F0F0F0W0
W0F0P0P0F0P0P0F0P0P0F0P0P0F0W0W0W0W0W0D1W0W0W0W0W0W0W0W0W0W0W0W0F0F0F0F0W0W0W0W0F0F0F0F0F0F0F0F0F0W0
W0F0F0F0F0F0F0F0F0F0F0F0F0F0W0W0W0F0F0F0F0F0W0W0W0W0W0W0W0W0W0W0F0F0F0F0W0F0E0W0F0F0F0F0F0F0F0F0F0W0
W0F0W0F0W0F0W0F0W0F0W0F0W0F0W0W0F0F0W0K1W0F0F0W0W0W0W0W0W0W0W0W0P0F0B0F0F0F0F0W0F0F0F0F0F0F0F0F0F0W0
W0F0W0F0W0F0W0F0W0F0W0F0W0F0D0F0F0F0L0W0L0F0F0D3F0E0W0W0W0W0W0W0F0F0F0F0W0F0F0W0F0F0F0F0F0F0F0F0F0W0
W0F0F0F0F0F0F0F0F0F0F0F0F0F0W0W0F0F0W0A0W0F0F0W0W0W0W0W0W0W0W0W0W0W0W0W0W0W0W0W0F0F0F0F0F0F0F0F0F0W0
W0W0W0W0F0W0W0W0W0W0F0W0W0W0W0W0W0F0F0F0F0F0W0P0P0P0P0W0W0W0W0W0F0F0F0F0F0F0F0F0F0F0F0F0F0F0F0F0F0W0
W0W0W0W0F0W0F0G0F0W0F0W0W0P0P0P0W0W0W0D2W0W0P0F0F0F0F0P0W0W0W0W0F0F0F0F0F0F0F0F0F0F0F0F0F0F0F0F0F0W0
W0W0W0W0F0F0F0F0F0F0F0W0P0F0F0F0P0W0P0F0P0P0P0F0P0P0F0P0W0W0W0W0F0F0F0F0F0F0F0F0F0F0F0F0F0F0F0F0F0W0
W0W0W0W0F0F0A0F0A0F0F0W0P0P0W0P0P0P0P0F0P0G0F0F0F0P0F0P0F0P0F0W0F0F0F0F0F0F0F0F0F0F0F0F0F0F0F0F0F0W0
W0W0W0W0W0W0W0W0W0W0W0W0P0F0F0F0P0F0F0F0F0F0P0P0A0F0F0P0F0P0F0W0F0F0F0F0F0F0F0F0F0F0F0F0F0F0F0F0F0W0
W0W0W0W0W0W0W0W0W0W0W0W0P0L0P0G0P0F0P0F0P0F0F0F0F0P0P0P0F0P0F0W0F0F0F0F0F0F0F0F0F0F0F0F0F0F0F0F0F0W0
W0W0W0W0W0W0W0W0W0W0W0W0W0P0P0F0P0F0F0F0F0P0P0P0P0P0L0P0W0W0W0W0F0F0F0F0F0F0F0F0F0F0F0F0F0F0F0F0F0W0
W0W0W0W0W0W0W0W0W0W0W0W0W0P0F0F0F0F0P0P0F0F0F0F0F0F0F0P0W0W0W0W0F0F0F0F0F0F0F0F0F0F0F0F0F0F0F0F0F0W0
W0W0W0W0W0W0W0W0W0W0W0P0P0P0F0P0P0P0L0P0P0P0P0P0P0P0P0P0W0W0W0W0F0F0F0F0F0F0F0F0F0F0F0F0F0F0F0F0F0W0
W0W0W0W0W0W0W0W0W0W0P0A0A0P0F0F0F0F0F0F0F0P0F0F0F0P0F0F0K3W0W0W0F0F0F0F0F0F0F0F0F0F0F0F0F0F0F0F0F0W0
W0W0W0W0W0W0W0W0W0W0W0P0P0P0P0P0P0P0P0P0F0F0F0P0F0F0F0P0W0W0W0W0F0F0F0F0F0F0F0F0F0F0F0F0F0F0F0F0F0W0
W0W0W0W0W0W0W0W0W0W0W0W0W0W0W0W0W0W0W0P0P0P0P0P0P0P0P0P0W0W0W0W0F0F0F0F0F0F0F0F0F0F0F0F0F0F0F0F0F0W0
W0W0W0W0W0W0W0W0W0W0W0W0W0W0W0W0W0W0W0W0W0W0W0W0W0W0W0W0W0W0W0W0F0F0F0F0F0F0F0F0F0F0F0F0F0F0F0F0F0W0
W0F0F0F0F0F0F0F0F0F0F0F0F0F0F0F0F0F0F0F0F0F0F0F0F0F0F0F0F0F0F0F0F0F0F0F0F0F0F0F0F0F0F0F0F0F0F0F0F0W0
W0F0F0F0F0F0F0F0F0F0F0F0F0F0F0F0F0F0F0F0F0F0F0F0F0F0F0F0F0F0F0F0F0F0F0F0F0F0F0F0F0F0F0F0F0F0F0F0F0W0
W0F0F0F0F0F0F0F0F0F0F0F0F0F0F0F0F0F0F0F0F0F0F0F0F0F0F0F0F0F0F0F0F0F0F0F0F0F0F0F0F0F0F0F0F0F0F0F0F0W0
W0F0F0F0F0F0F0F0F0F0F0F0F0F0F0F0F0F0F0F0F0F0F0F0F0F0F0F0F0F0F0F0F0F0F0F0F0F0F0F0F0F0F0F0F0F0F0F0F0W0
W0F0F0F0F0F0F0F0F0F0F0F0F0F0F0F0F0F0F0F0F0F0F0F0F0F0F0F0F0F0F0F0F0F0F0F0F0F0F0F0F0F0F0F0F0F0F0F0F0W0
W0F0F0F0F0F0F0F0F0F0F0F0F0F0F0F0F0F0F0F0F0F0F0F0F0F0F0F0F0F0F0F0F0F0F0F0F0F0F0F0F0F0F0F0F0F0F0F0F0W0
W0F0F0F0F0F0F0F0F0F0F0F0F0F0F0F0F0F0F0F0F0F0F0F0F0F0F0F0F0F0F0F0F0F0F0F0F0F0F0F0F0F0F0F0F0F0F0F0F0W0
W0F0F0F0F0F0F0F0F0F0F0F0F0F0F0F0F0F0F0F0F0F0F0F0F0F0F0F0F0F0F0F0F0F0F0F0F0F0F0F0F0F0F0F0F0F0F0F0F0W0
W0F0F0F0F0F0F0F0F0F0F0F0F0F0F0F0F0F0F0F0F0F0F0F0F0F0F0F0F0F0F0F0F0F0F0F0F0F0F0F0F0F0F0F0F0F0F0F0F0W0
W0F0F0F0F0F0F0F0F0F0F0F0F0F0F0F0F0F0F0F0F0F0F0F0F0F0F0F0F0F0F0F0F0F0F0F0F0F0F0F0F0F0F0F0F0F0F0F0F0W0
W0F0F0F0F0F0F0F0F0F0F0F0F0F0F0F0F0F0F0F0F0F0F0F0F0F0F0F0F0F0F0F0F0F0F0F0F0F0F0F0F0F0F0F0F0F0F0F0F0W0
W0F0F0F0F0F0F0F0F0F0F0F0F0F0F0F0F0F0F0F0F0F0F0F0F0F0F0F0F0F0F0F0F0F0F0F0F0F0F0F0F0F0F0F0F0F0F0F0F0W0
W0F0F0F0F0F0F0F0F0F0F0F0F0F0F0F0F0F0F0F0F0F0F0F0F0F0F0F0F0F0F0F0F0F0F0F0F0F0F0F0F0F0F0F0F0F0F0F0F0W0
W0F0F0F0F0F0F0F0F0F0F0F0F0F0F0F0F0F0F0F0F0F0F0F0F0F0F0F0F0F0F0F0F0F0F0F0F0F0F0F0F0F0F0F0F0F0F0F0F0W0
W0F0F0F0F0F0F0F0F0F0F0F0F0F0F0F0F0F0F0F0F0F0F0F0F0F0F0F0F0F0F0F0F0F0F0F0F0F0F0F0F0F0F0F0F0F0F0F0F0W0
W0F0F0F0F0F0F0F0F0F0F0F0F0F0F0F0F0F0F0F0F0F0F0F0F0F0F0F0F0F0F0F0F0F0F0F0F0F0F0F0F0F0F0F0F0F0F0F0F0W0
W0F0F0F0F0F0F0F0F0F0F0F0F0F0F0F0F0F0F0F0F0F0F0F0F0F0F0F0F0F0F0F0F0F0F0F0F0F0F0F0F0F0F0F0F0F0F0F0F0W0
W0F0F0F0F0F0F0F0F0F0F0F0F0F0F0F0F0F0F0F0F0F0F0F0F0F0F0F0F0F0F0F0F0F0F0F0F0F0F0F0F0F0F0F0F0F0F0F0F0W0
W0F0F0F0F0F0F0F0F0F0F0F0F0F0F0F0F0F0F0F0F0F0F0F0F0F0F0F0F0F0F0F0F0F0F0F0F0F0F0F0F0F0F0F0F0F0F0F0F0W0
W0F0F0F0F0F0F0F0F0F0F0F0F0F0F0F0F0F0F0F0F0F0F0F0F0F0F0F0F0F0F0F0F0F0F0F0F0F0F0F0F0F0F0F0F0F0F0F0F0W0
W0F0F0F0F0F0F0F0F0F0F0F0F0F0F0F0F0F0F0F0F0F0F0F0F0F0F0F0F0F0F0F0F0F0F0F0F0F0F0F0F0F0F0F0F0F0F0F0F0W0
W0F0F0F0F0F0F0F0F0F0F0F0F0F0F0F0F0F0F0F0F0F0F0F0F0F0F0F0F0F0F0F0F0F0F0F0F0F0F0F0F0F0F0F0F0F0F0F0F0W0
W0F0F0F0F0F0F0F0F0F0F0F0F0F0F0F0F0F0F0F0F0F0F0F0F0F0F0F0F0F0F0F0F0F0F0F0F0F0F0F0F0F0F0F0F0F0F0F0F0W0
W0W0W0W0W0W0W0W0W0W0W0W0W0W0W0W0W0W0W0W0W0W0W0W0W0W0W0W0W0W0W0W0W0W0W0W0W0W0W0W0W0W0W0W0W0W0W0W0W0W0
